年份,考生所在地,考生类别,分数段,本段人数,累计人数
2019,上海,综合,615分及以上,53,53
2019,上海,综合,614,11,64
2019,上海,综合,613,13,77
2019,上海,综合,612,10,87
2019,上海,综合,611,14,101
2019,上海,综合,610,8,109
2019,上海,综合,609,18,127
2019,上海,综合,608,23,150
2019,上海,综合,607,17,167
2019,上海,综合,606,20,187
2019,上海,综合,605,27,214
2019,上海,综合,604,16,230
2019,上海,综合,603,28,258
2019,上海,综合,602,24,282
2019,上海,综合,601,30,312
2019,上海,综合,600,31,343
2019,上海,综合,599,31,374
2019,上海,综合,598,30,404
2019,上海,综合,597,42,446
2019,上海,综合,596,38,484
2019,上海,综合,595,38,522
2019,上海,综合,594,44,566
2019,上海,综合,593,46,612
2019,上海,综合,592,61,673
2019,上海,综合,591,46,719
2019,上海,综合,590,49,768
2019,上海,综合,589,52,820
2019,上海,综合,588,63,883
2019,上海,综合,587,69,952
2019,上海,综合,586,78,1030
2019,上海,综合,585,76,1106
2019,上海,综合,584,89,1195
2019,上海,综合,583,80,1275
2019,上海,综合,582,70,1345
2019,上海,综合,581,74,1419
2019,上海,综合,580,87,1506
2019,上海,综合,579,73,1579
2019,上海,综合,578,77,1656
2019,上海,综合,577,86,1742
2019,上海,综合,576,76,1818
2019,上海,综合,575,74,1892
2019,上海,综合,574,89,1981
2019,上海,综合,573,91,2072
2019,上海,综合,572,97,2169
2019,上海,综合,571,108,2277
2019,上海,综合,570,99,2376
2019,上海,综合,569,119,2495
2019,上海,综合,568,114,2609
2019,上海,综合,567,104,2713
2019,上海,综合,566,121,2834
2019,上海,综合,565,139,2973
2019,上海,综合,564,151,3124
2019,上海,综合,563,121,3245
2019,上海,综合,562,119,3364
2019,上海,综合,561,136,3500
2019,上海,综合,560,136,3636
2019,上海,综合,559,151,3787
2019,上海,综合,558,113,3900
2019,上海,综合,557,152,4052
2019,上海,综合,556,120,4172
2019,上海,综合,555,118,4290
2019,上海,综合,554,160,4450
2019,上海,综合,553,167,4617
2019,上海,综合,552,164,4781
2019,上海,综合,551,165,4946
2019,上海,综合,550,155,5101
2019,上海,综合,549,173,5274
2019,上海,综合,548,163,5437
2019,上海,综合,547,173,5610
2019,上海,综合,546,163,5773
2019,上海,综合,545,168,5941
2019,上海,综合,544,194,6135
2019,上海,综合,543,190,6325
2019,上海,综合,542,187,6512
2019,上海,综合,541,210,6722
2019,上海,综合,540,189,6911
2019,上海,综合,539,195,7106
2019,上海,综合,538,193,7299
2019,上海,综合,537,195,7494
2019,上海,综合,536,200,7694
2019,上海,综合,535,190,7884
2019,上海,综合,534,179,8063
2019,上海,综合,533,185,8248
2019,上海,综合,532,225,8473
2019,上海,综合,531,207,8680
2019,上海,综合,530,212,8892
2019,上海,综合,529,210,9102
2019,上海,综合,528,209,9311
2019,上海,综合,527,220,9531
2019,上海,综合,526,216,9747
2019,上海,综合,525,218,9965
2019,上海,综合,524,212,10177
2019,上海,综合,523,230,10407
2019,上海,综合,522,200,10607
2019,上海,综合,521,209,10816
2019,上海,综合,520,204,11020
2019,上海,综合,519,199,11219
2019,上海,综合,518,202,11421
2019,上海,综合,517,199,11620
2019,上海,综合,516,226,11846
2019,上海,综合,515,206,12052
2019,上海,综合,514,207,12259
2019,上海,综合,513,236,12495
2019,上海,综合,512,194,12689
2019,上海,综合,511,236,12925
2019,上海,综合,510,228,13153
2019,上海,综合,509,254,13407
2019,上海,综合,508,245,13652
2019,上海,综合,507,217,13869
2019,上海,综合,506,230,14099
2019,上海,综合,505,245,14344
2019,上海,综合,504,212,14556
2019,上海,综合,503,203,14759
2019,上海,综合,502,207,14966
2019,上海,综合,501,229,15195
2019,上海,综合,500,219,15414
2019,上海,综合,499,246,15660
2019,上海,综合,498,225,15885
2019,上海,综合,497,239,16124
2019,上海,综合,496,242,16366
2019,上海,综合,495,244,16610
2019,上海,综合,494,238,16848
2019,上海,综合,493,244,17092
2019,上海,综合,492,253,17345
2019,上海,综合,491,229,17574
2019,上海,综合,490,225,17799
2019,上海,综合,489,238,18037
2019,上海,综合,488,250,18287
2019,上海,综合,487,227,18514
2019,上海,综合,486,239,18753
2019,上海,综合,485,227,18980
2019,上海,综合,484,239,19219
2019,上海,综合,483,241,19460
2019,上海,综合,482,250,19710
2019,上海,综合,481,226,19936
2019,上海,综合,480,233,20169
2019,上海,综合,479,227,20396
2019,上海,综合,478,225,20621
2019,上海,综合,477,242,20863
2019,上海,综合,476,262,21125
2019,上海,综合,475,253,21378
2019,上海,综合,474,225,21603
2019,上海,综合,473,254,21857
2019,上海,综合,472,225,22082
2019,上海,综合,471,215,22297
2019,上海,综合,470,253,22550
2019,上海,综合,469,205,22755
2019,上海,综合,468,227,22982
2019,上海,综合,467,188,23170
2019,上海,综合,466,225,23395
2019,上海,综合,465,202,23597
2019,上海,综合,464,230,23827
2019,上海,综合,463,212,24039
2019,上海,综合,462,255,24294
2019,上海,综合,461,234,24528
2019,上海,综合,460,225,24753
2019,上海,综合,459,205,24958
2019,上海,综合,458,210,25168
2019,上海,综合,457,241,25409
2019,上海,综合,456,209,25618
2019,上海,综合,455,193,25811
2019,上海,综合,454,215,26026
2019,上海,综合,453,230,26256
2019,上海,综合,452,207,26463
2019,上海,综合,451,203,26666
2019,上海,综合,450,210,26876
2019,上海,综合,449,226,27102
2019,上海,综合,448,225,27327
2019,上海,综合,447,220,27547
2019,上海,综合,446,232,27779
2019,上海,综合,445,192,27971
2019,上海,综合,444,201,28172
2019,上海,综合,443,207,28379
2019,上海,综合,442,185,28564
2019,上海,综合,441,213,28777
2019,上海,综合,440,190,28967
2019,上海,综合,439,209,29176
2019,上海,综合,438,170,29346
2019,上海,综合,437,193,29539
2019,上海,综合,436,192,29731
2019,上海,综合,435,191,29922
2019,上海,综合,434,216,30138
2019,上海,综合,433,211,30349
2019,上海,综合,432,201,30550
2019,上海,综合,431,206,30756
2019,上海,综合,430,176,30932
2019,上海,综合,429,181,31113
2019,上海,综合,428,196,31309
2019,上海,综合,427,211,31520
2019,上海,综合,426,196,31716
2019,上海,综合,425,177,31893
2019,上海,综合,424,153,32046
2019,上海,综合,423,178,32224
2019,上海,综合,422,183,32407
2019,上海,综合,421,191,32598
2019,上海,综合,420,166,32764
2019,上海,综合,419,175,32939
2019,上海,综合,418,174,33113
2019,上海,综合,417,166,33279
2019,上海,综合,416,169,33448
2019,上海,综合,415,171,33619
2019,上海,综合,414,162,33781
2019,上海,综合,413,180,33961
2019,上海,综合,412,168,34129
2019,上海,综合,411,159,34288
2019,上海,综合,410,166,34454
2019,上海,综合,409,131,34585
2019,上海,综合,408,172,34757
2019,上海,综合,407,150,34907
2019,上海,综合,406,170,35077
2019,上海,综合,405,162,35239
2019,上海,综合,404,167,35406
2019,上海,综合,403,163,35569
2019,上海,综合,402,157,35726
2019,上海,综合,401,147,35873
2019,上海,综合,400,180,36053
2019,上海,综合,399,128,36181
2019,上海,综合,398,129,36310
2019,上海,综合,397,165,36475
2019,上海,综合,396,135,36610
2019,上海,综合,395,164,36774
2019,上海,综合,394,144,36918
2019,上海,综合,393,147,37065
2019,上海,综合,392,186,37251
2019,上海,综合,391,123,37374
2019,上海,综合,390,140,37514
2019,上海,综合,389,135,37649
2019,上海,综合,388,140,37789
2019,上海,综合,387,119,37908
2019,上海,综合,386,116,38024
2019,上海,综合,385,146,38170
2019,上海,综合,384,117,38287
2019,上海,综合,383,119,38406
2019,上海,综合,382,117,38523
2019,上海,综合,381,107,38630
2019,上海,综合,380,104,38734
2019,上海,综合,379,128,38862
2019,上海,综合,378,101,38963
2019,上海,综合,377,110,39073
2019,上海,综合,376,103,39176
2019,上海,综合,375,117,39293
2019,上海,综合,374,103,39396
2019,上海,综合,373,96,39492
2019,上海,综合,372,104,39596
2019,上海,综合,371,91,39687
2019,上海,综合,370,109,39796
2019,上海,综合,369,100,39896
2019,上海,综合,368,88,39984
2019,上海,综合,367,95,40079
2019,上海,综合,366,93,40172
2019,上海,综合,365,88,40260
2019,上海,综合,364,99,40359
2019,上海,综合,363,101,40460
2019,上海,综合,362,89,40549
2019,上海,综合,361,82,40631
2019,上海,综合,360,87,40718
2019,上海,综合,359,90,40808
2019,上海,综合,358,79,40887
2019,上海,综合,357,75,40962
2019,上海,综合,356,81,41043
2019,上海,综合,355,86,41129
2019,上海,综合,354,70,41199
2019,上海,综合,353,76,41275
2019,上海,综合,352,75,41350
2019,上海,综合,351,74,41424
2019,上海,综合,350,71,41495
2019,上海,综合,349,63,41558
2019,上海,综合,348,65,41623
2019,上海,综合,347,65,41688
2019,上海,综合,346,65,41753
2019,上海,综合,345,80,41833
2019,上海,综合,344,53,41886
2019,上海,综合,343,83,41969
2019,上海,综合,342,60,42029
2019,上海,综合,341,53,42082
2019,上海,综合,340,57,42139
2019,上海,综合,339,55,42194
2019,上海,综合,338,52,42246
2019,上海,综合,337,66,42312
2019,上海,综合,336,48,42360
2019,上海,综合,335,48,42408
2019,上海,综合,334,41,42449
2019,上海,综合,333,40,42489
2019,上海,综合,332,55,42544
2019,上海,综合,331,41,42585
2019,上海,综合,330,38,42623
2019,上海,综合,329,42,42665
2019,上海,综合,328,38,42703
2019,上海,综合,327,40,42743
2019,上海,综合,326,43,42786
2019,上海,综合,325,38,42824
2019,上海,综合,324,46,42870
2019,上海,综合,323,31,42901
2019,上海,综合,322,30,42931
2019,上海,综合,321,24,42955
2019,上海,综合,320,32,42987
2019,上海,综合,319,39,43026
2019,上海,综合,318,35,43061
2019,上海,综合,317,34,43095
2019,上海,综合,316,33,43128
2019,上海,综合,315,36,43164
2019,上海,综合,314,30,43194
2019,上海,综合,313,24,43218
2019,上海,综合,312,32,43250
2019,上海,综合,311,38,43288
2019,上海,综合,310,15,43303
2019,上海,综合,309,35,43338
2019,上海,综合,308,19,43357
2019,上海,综合,307,33,43390
2019,上海,综合,306,23,43413
2019,上海,综合,305,21,43434
2019,上海,综合,304,21,43455
2019,上海,综合,303,22,43477
2019,上海,综合,302,19,43496
2019,上海,综合,301,27,43523
2019,上海,综合,300,25,43548
2019,上海,综合,299,19,43567
2019,上海,综合,298,15,43582
2019,上海,综合,297,15,43597
2019,上海,综合,296,15,43612
2019,上海,综合,295,20,43632
2019,上海,综合,294,20,43652
2019,上海,综合,293,25,43677
2019,上海,综合,292,19,43696
2019,上海,综合,291,11,43707
2019,上海,综合,290,17,43724
2019,上海,综合,289,24,43748
2019,上海,综合,288,14,43762
2019,上海,综合,287,18,43780
2019,上海,综合,286,20,43800
2019,上海,综合,285,10,43810
2019,上海,综合,284,14,43824
2019,上海,综合,283,17,43841
2019,上海,综合,282,15,43856
2019,上海,综合,281,13,43869
2019,上海,综合,280,10,43879
2019,上海,综合,279,9,43888
2019,上海,综合,278,14,43902
2019,上海,综合,277,11,43913
2019,上海,综合,276,15,43928
2019,上海,综合,275,9,43937
2019,上海,综合,274,7,43944
2019,上海,综合,273,4,43948
2019,上海,综合,272,5,43953
2019,上海,综合,271,9,43962
2019,上海,综合,270,8,43970
2019,上海,综合,269,16,43986
2019,上海,综合,268,14,44000
2019,上海,综合,267,11,44011
2019,上海,综合,266,7,44018
2019,上海,综合,265,9,44027
2019,上海,综合,264,8,44035
2019,上海,综合,263,6,44041
2019,上海,综合,262,7,44048
2018,上海,综合,611分及以上,52,52
2018,上海,综合,610,10,62
2018,上海,综合,609,12,74
2018,上海,综合,608,9,83
2018,上海,综合,607,22,105
2018,上海,综合,606,15,120
2018,上海,综合,605,13,133
2018,上海,综合,604,16,149
2018,上海,综合,603,19,168
2018,上海,综合,602,18,186
2018,上海,综合,601,23,209
2018,上海,综合,600,26,235
2018,上海,综合,599,40,275
2018,上海,综合,598,19,294
2018,上海,综合,597,41,335
2018,上海,综合,596,41,376
2018,上海,综合,595,32,408
2018,上海,综合,594,38,446
2018,上海,综合,593,35,481
2018,上海,综合,592,41,522
2018,上海,综合,591,45,567
2018,上海,综合,590,46,613
2018,上海,综合,589,47,660
2018,上海,综合,588,58,718
2018,上海,综合,587,64,782
2018,上海,综合,586,63,845
2018,上海,综合,585,63,908
2018,上海,综合,584,69,977
2018,上海,综合,583,79,1056
2018,上海,综合,582,54,1110
2018,上海,综合,581,90,1200
2018,上海,综合,580,73,1273
2018,上海,综合,579,72,1345
2018,上海,综合,578,87,1432
2018,上海,综合,577,78,1510
2018,上海,综合,576,82,1592
2018,上海,综合,575,93,1685
2018,上海,综合,574,81,1766
2018,上海,综合,573,96,1862
2018,上海,综合,572,95,1957
2018,上海,综合,571,104,2061
2018,上海,综合,570,98,2159
2018,上海,综合,569,84,2243
2018,上海,综合,568,106,2349
2018,上海,综合,567,113,2462
2018,上海,综合,566,111,2573
2018,上海,综合,565,104,2677
2018,上海,综合,564,140,2817
2018,上海,综合,563,122,2939
2018,上海,综合,562,113,3052
2018,上海,综合,561,128,3180
2018,上海,综合,560,140,3320
2018,上海,综合,559,143,3463
2018,上海,综合,558,144,3607
2018,上海,综合,557,131,3738
2018,上海,综合,556,145,3883
2018,上海,综合,555,156,4039
2018,上海,综合,554,161,4200
2018,上海,综合,553,160,4360
2018,上海,综合,552,148,4508
2018,上海,综合,551,165,4673
2018,上海,综合,550,161,4834
2018,上海,综合,549,170,5004
2018,上海,综合,548,162,5166
2018,上海,综合,547,154,5320
2018,上海,综合,546,164,5484
2018,上海,综合,545,170,5654
2018,上海,综合,544,178,5832
2018,上海,综合,543,188,6020
2018,上海,综合,542,187,6207
2018,上海,综合,541,181,6388
2018,上海,综合,540,171,6559
2018,上海,综合,539,172,6731
2018,上海,综合,538,188,6919
2018,上海,综合,537,184,7103
2018,上海,综合,536,186,7289
2018,上海,综合,535,175,7464
2018,上海,综合,534,179,7643
2018,上海,综合,533,204,7847
2018,上海,综合,532,171,8018
2018,上海,综合,531,198,8216
2018,上海,综合,530,190,8406
2018,上海,综合,529,170,8576
2018,上海,综合,528,198,8774
2018,上海,综合,527,192,8966
2018,上海,综合,526,205,9171
2018,上海,综合,525,195,9366
2018,上海,综合,524,215,9581
2018,上海,综合,523,212,9793
2018,上海,综合,522,196,9989
2018,上海,综合,521,210,10199
2018,上海,综合,520,206,10405
2018,上海,综合,519,206,10611
2018,上海,综合,518,238,10849
2018,上海,综合,517,203,11052
2018,上海,综合,516,227,11279
2018,上海,综合,515,237,11516
2018,上海,综合,514,227,11743
2018,上海,综合,513,240,11983
2018,上海,综合,512,199,12182
2018,上海,综合,511,215,12397
2018,上海,综合,510,229,12626
2018,上海,综合,509,250,12876
2018,上海,综合,508,246,13122
2018,上海,综合,507,219,13341
2018,上海,综合,506,249,13590
2018,上海,综合,505,215,13805
2018,上海,综合,504,239,14044
2018,上海,综合,503,217,14261
2018,上海,综合,502,236,14497
2018,上海,综合,501,206,14703
2018,上海,综合,500,236,14939
2018,上海,综合,499,272,15211
2018,上海,综合,498,231,15442
2018,上海,综合,497,238,15680
2018,上海,综合,496,258,15938
2018,上海,综合,495,235,16173
2018,上海,综合,494,216,16389
2018,上海,综合,493,235,16624
2018,上海,综合,492,245,16869
2018,上海,综合,491,226,17095
2018,上海,综合,490,239,17334
2018,上海,综合,489,277,17611
2018,上海,综合,488,262,17873
2018,上海,综合,487,251,18124
2018,上海,综合,486,245,18369
2018,上海,综合,485,257,18626
2018,上海,综合,484,223,18849
2018,上海,综合,483,252,19101
2018,上海,综合,482,229,19330
2018,上海,综合,481,255,19585
2018,上海,综合,480,230,19815
2018,上海,综合,479,234,20049
2018,上海,综合,478,234,20283
2018,上海,综合,477,208,20491
2018,上海,综合,476,248,20739
2018,上海,综合,475,256,20995
2018,上海,综合,474,249,21244
2018,上海,综合,473,232,21476
2018,上海,综合,472,215,21691
2018,上海,综合,471,245,21936
2018,上海,综合,470,208,22144
2018,上海,综合,469,230,22374
2018,上海,综合,468,221,22595
2018,上海,综合,467,259,22854
2018,上海,综合,466,233,23087
2018,上海,综合,465,214,23301
2018,上海,综合,464,225,23526
2018,上海,综合,463,238,23764
2018,上海,综合,462,264,24028
2018,上海,综合,461,218,24246
2018,上海,综合,460,214,24460
2018,上海,综合,459,249,24709
2018,上海,综合,458,230,24939
2018,上海,综合,457,220,25159
2018,上海,综合,456,281,25440
2018,上海,综合,455,218,25658
2018,上海,综合,454,230,25888
2018,上海,综合,453,220,26108
2018,上海,综合,452,198,26306
2018,上海,综合,451,214,26520
2018,上海,综合,450,197,26717
2018,上海,综合,449,212,26929
2018,上海,综合,448,192,27121
2018,上海,综合,447,225,27346
2018,上海,综合,446,226,27572
2018,上海,综合,445,210,27782
2018,上海,综合,444,208,27990
2018,上海,综合,443,202,28192
2018,上海,综合,442,224,28416
2018,上海,综合,441,212,28628
2018,上海,综合,440,222,28850
2018,上海,综合,439,202,29052
2018,上海,综合,438,212,29264
2018,上海,综合,437,196,29460
2018,上海,综合,436,199,29659
2018,上海,综合,435,202,29861
2018,上海,综合,434,192,30053
2018,上海,综合,433,197,30250
2018,上海,综合,432,182,30432
2018,上海,综合,431,200,30632
2018,上海,综合,430,184,30816
2018,上海,综合,429,189,31005
2018,上海,综合,428,174,31179
2018,上海,综合,427,177,31356
2018,上海,综合,426,190,31546
2018,上海,综合,425,168,31714
2018,上海,综合,424,182,31896
2018,上海,综合,423,195,32091
2018,上海,综合,422,155,32246
2018,上海,综合,421,151,32397
2018,上海,综合,420,170,32567
2018,上海,综合,419,204,32771
2018,上海,综合,418,175,32946
2018,上海,综合,417,179,33125
2018,上海,综合,416,160,33285
2018,上海,综合,415,167,33452
2018,上海,综合,414,170,33622
2018,上海,综合,413,161,33783
2018,上海,综合,412,126,33909
2018,上海,综合,411,164,34073
2018,上海,综合,410,165,34238
2018,上海,综合,409,157,34395
2018,上海,综合,408,175,34570
2018,上海,综合,407,161,34731
2018,上海,综合,406,170,34901
2018,上海,综合,405,165,35066
2018,上海,综合,404,156,35222
2018,上海,综合,403,131,35353
2018,上海,综合,402,163,35516
2018,上海,综合,401,153,35669
2018,上海,综合,400,141,35810
2018,上海,综合,399,151,35961
2018,上海,综合,398,134,36095
2018,上海,综合,397,144,36239
2018,上海,综合,396,131,36370
2018,上海,综合,395,136,36506
2018,上海,综合,394,151,36657
2018,上海,综合,393,132,36789
2018,上海,综合,392,142,36931
2018,上海,综合,391,142,37073
2018,上海,综合,390,130,37203
2018,上海,综合,389,137,37340
2018,上海,综合,388,147,37487
2018,上海,综合,387,124,37611
2018,上海,综合,386,121,37732
2018,上海,综合,385,124,37856
2018,上海,综合,384,123,37979
2018,上海,综合,383,109,38088
2018,上海,综合,382,107,38195
2018,上海,综合,381,111,38306
2018,上海,综合,380,101,38407
2018,上海,综合,379,106,38513
2018,上海,综合,378,101,38614
2018,上海,综合,377,107,38721
2018,上海,综合,376,120,38841
2018,上海,综合,375,111,38952
2018,上海,综合,374,102,39054
2018,上海,综合,373,122,39176
2018,上海,综合,372,91,39267
2018,上海,综合,371,102,39369
2018,上海,综合,370,108,39477
2018,上海,综合,369,104,39581
2018,上海,综合,368,107,39688
2018,上海,综合,367,94,39782
2018,上海,综合,366,107,39889
2018,上海,综合,365,92,39981
2018,上海,综合,364,89,40070
2018,上海,综合,363,88,40158
2018,上海,综合,362,92,40250
2018,上海,综合,361,81,40331
2018,上海,综合,360,88,40419
2018,上海,综合,359,77,40496
2018,上海,综合,358,82,40578
2018,上海,综合,357,80,40658
2018,上海,综合,356,74,40732
2018,上海,综合,355,81,40813
2018,上海,综合,354,68,40881
2018,上海,综合,353,76,40957
2018,上海,综合,352,75,41032
2018,上海,综合,351,74,41106
2018,上海,综合,350,77,41183
2018,上海,综合,349,59,41242
2018,上海,综合,348,54,41296
2018,上海,综合,347,70,41366
2018,上海,综合,346,56,41422
2018,上海,综合,345,58,41480
2018,上海,综合,344,74,41554
2018,上海,综合,343,55,41609
2018,上海,综合,342,45,41654
2018,上海,综合,341,62,41716
2018,上海,综合,340,63,41779
2018,上海,综合,339,49,41828
2018,上海,综合,338,34,41862
2018,上海,综合,337,45,41907
2018,上海,综合,336,48,41955
2018,上海,综合,335,38,41993
2018,上海,综合,334,46,42039
2018,上海,综合,333,41,42080
2018,上海,综合,332,55,42135
2018,上海,综合,331,29,42164
2018,上海,综合,330,42,42206
2018,上海,综合,329,45,42251
2018,上海,综合,328,35,42286
2018,上海,综合,327,42,42328
2018,上海,综合,326,35,42363
2018,上海,综合,325,40,42403
2018,上海,综合,324,27,42430
2018,上海,综合,323,41,42471
2018,上海,综合,322,30,42501
2018,上海,综合,321,33,42534
2018,上海,综合,320,32,42566
2018,上海,综合,319,34,42600
2018,上海,综合,318,23,42623
2018,上海,综合,317,32,42655
2018,上海,综合,316,21,42676
2018,上海,综合,315,32,42708
2018,上海,综合,314,26,42734
2018,上海,综合,313,30,42764
2018,上海,综合,312,28,42792
2018,上海,综合,311,17,42809
2018,上海,综合,310,24,42833
2018,上海,综合,309,19,42852
2018,上海,综合,308,23,42875
2018,上海,综合,307,25,42900
2018,上海,综合,306,18,42918
2018,上海,综合,305,15,42933
2018,上海,综合,304,14,42947
2018,上海,综合,303,14,42961
2018,上海,综合,302,14,42975
2018,上海,综合,301,26,43001
2018,上海,综合,300,21,43022
2018,上海,综合,299,23,43045
2018,上海,综合,298,17,43062
2018,上海,综合,297,13,43075
2018,上海,综合,296,9,43084
2018,上海,综合,295,17,43101
2018,上海,综合,294,12,43113
2018,上海,综合,293,18,43131
2018,上海,综合,292,16,43147
2018,上海,综合,291,15,43162
2018,上海,综合,290,11,43173
2018,上海,综合,289,16,43189
2018,上海,综合,288,10,43199
2018,上海,综合,287,9,43208
2018,上海,综合,286,12,43220
2018,上海,综合,285,14,43234
2018,上海,综合,284,7,43241
2018,上海,综合,283,13,43254
2018,上海,综合,282,9,43263
2018,上海,综合,281,8,43271
2018,上海,综合,280,12,43283
2018,上海,综合,279,6,43289
2018,上海,综合,278,3,43292
2018,上海,综合,277,5,43297
2018,上海,综合,276,4,43301
2018,上海,综合,275,8,43309
2018,上海,综合,274,10,43319
2018,上海,综合,273,6,43325
2018,上海,综合,272,10,43335
2018,上海,综合,271,2,43337
2018,上海,综合,270,8,43345
2018,上海,综合,269,10,43355
2018,上海,综合,268,5,43360
2018,上海,综合,267,4,43364
2018,上海,综合,266,9,43373
2018,上海,综合,265,8,43381
2018,上海,综合,264,9,43390
2018,上海,综合,263,5,43395
2018,上海,综合,262,9,43404
2018,上海,综合,261,5,43409
2017,上海,综合,604及以上,47,47
2017,上海,综合,603,8,55
2017,上海,综合,602,14,69
2017,上海,综合,601,16,85
2017,上海,综合,600,16,101
2017,上海,综合,599,11,112
2017,上海,综合,598,16,128
2017,上海,综合,597,9,137
2017,上海,综合,596,19,156
2017,上海,综合,595,23,179
2017,上海,综合,594,16,195
2017,上海,综合,593,25,220
2017,上海,综合,592,29,249
2017,上海,综合,591,30,279
2017,上海,综合,590,44,323
2017,上海,综合,589,34,357
2017,上海,综合,588,37,394
2017,上海,综合,587,45,439
2017,上海,综合,586,34,473
2017,上海,综合,585,41,514
2017,上海,综合,584,44,558
2017,上海,综合,583,48,606
2017,上海,综合,582,44,650
2017,上海,综合,581,62,712
2017,上海,综合,580,59,771
2017,上海,综合,579,89,860
2017,上海,综合,578,69,929
2017,上海,综合,577,74,1003
2017,上海,综合,576,80,1083
2017,上海,综合,575,76,1159
2017,上海,综合,574,83,1242
2017,上海,综合,573,98,1340
2017,上海,综合,572,87,1427
2017,上海,综合,571,92,1519
2017,上海,综合,570,102,1621
2017,上海,综合,569,82,1703
2017,上海,综合,568,96,1799
2017,上海,综合,567,113,1912
2017,上海,综合,566,88,2000
2017,上海,综合,565,148,2148
2017,上海,综合,564,115,2263
2017,上海,综合,563,138,2401
2017,上海,综合,562,124,2525
2017,上海,综合,561,133,2658
2017,上海,综合,560,134,2792
2017,上海,综合,559,132,2924
2017,上海,综合,558,132,3056
2017,上海,综合,557,144,3200
2017,上海,综合,556,123,3323
2017,上海,综合,555,133,3456
2017,上海,综合,554,129,3585
2017,上海,综合,553,128,3713
2017,上海,综合,552,155,3868
2017,上海,综合,551,170,4038
2017,上海,综合,550,139,4177
2017,上海,综合,549,156,4333
2017,上海,综合,548,136,4469
2017,上海,综合,547,154,4623
2017,上海,综合,546,191,4814
2017,上海,综合,545,159,4973
2017,上海,综合,544,145,5118
2017,上海,综合,543,185,5303
2017,上海,综合,542,190,5493
2017,上海,综合,541,210,5703
2017,上海,综合,540,172,5875
2017,上海,综合,539,193,6068
2017,上海,综合,538,198,6266
2017,上海,综合,537,190,6456
2017,上海,综合,536,195,6651
2017,上海,综合,535,197,6848
2017,上海,综合,534,200,7048
2017,上海,综合,533,192,7240
2017,上海,综合,532,184,7424
2017,上海,综合,531,212,7636
2017,上海,综合,530,196,7832
2017,上海,综合,529,209,8041
2017,上海,综合,528,225,8266
2017,上海,综合,527,198,8464
2017,上海,综合,526,203,8667
2017,上海,综合,525,201,8868
2017,上海,综合,524,195,9063
2017,上海,综合,523,240,9303
2017,上海,综合,522,242,9545
2017,上海,综合,521,231,9776
2017,上海,综合,520,209,9985
2017,上海,综合,519,243,10228
2017,上海,综合,518,196,10424
2017,上海,综合,517,237,10661
2017,上海,综合,516,226,10887
2017,上海,综合,515,225,11112
2017,上海,综合,514,245,11357
2017,上海,综合,513,226,11583
2017,上海,综合,512,212,11795
2017,上海,综合,511,252,12047
2017,上海,综合,510,254,12301
2017,上海,综合,509,223,12524
2017,上海,综合,508,242,12766
2017,上海,综合,507,240,13006
2017,上海,综合,506,235,13241
2017,上海,综合,505,222,13463
2017,上海,综合,504,252,13715
2017,上海,综合,503,221,13936
2017,上海,综合,502,232,14168
2017,上海,综合,501,224,14392
2017,上海,综合,500,228,14620
2017,上海,综合,499,256,14876
2017,上海,综合,498,225,15101
2017,上海,综合,497,228,15329
2017,上海,综合,496,233,15562
2017,上海,综合,495,237,15799
2017,上海,综合,494,268,16067
2017,上海,综合,493,242,16309
2017,上海,综合,492,261,16570
2017,上海,综合,491,262,16832
2017,上海,综合,490,214,17046
2017,上海,综合,489,255,17301
2017,上海,综合,488,234,17535
2017,上海,综合,487,250,17785
2017,上海,综合,486,249,18034
2017,上海,综合,485,261,18295
2017,上海,综合,484,241,18536
2017,上海,综合,483,225,18761
2017,上海,综合,482,239,19000
2017,上海,综合,481,243,19243
2017,上海,综合,480,256,19499
2017,上海,综合,479,275,19774
2017,上海,综合,478,245,20019
2017,上海,综合,477,262,20281
2017,上海,综合,476,227,20508
2017,上海,综合,475,233,20741
2017,上海,综合,474,211,20952
2017,上海,综合,473,244,21196
2017,上海,综合,472,241,21437
2017,上海,综合,471,264,21701
2017,上海,综合,470,219,21920
2017,上海,综合,469,233,22153
2017,上海,综合,468,255,22408
2017,上海,综合,467,216,22624
2017,上海,综合,466,247,22871
2017,上海,综合,465,208,23079
2017,上海,综合,464,208,23287
2017,上海,综合,463,253,23540
2017,上海,综合,462,212,23752
2017,上海,综合,461,246,23998
2017,上海,综合,460,237,24235
2017,上海,综合,459,237,24472
2017,上海,综合,458,226,24698
2017,上海,综合,457,240,24938
2017,上海,综合,456,226,25164
2017,上海,综合,455,227,25391
2017,上海,综合,454,241,25632
2017,上海,综合,453,215,25847
2017,上海,综合,452,219,26066
2017,上海,综合,451,248,26314
2017,上海,综合,450,236,26550
2017,上海,综合,449,213,26763
2017,上海,综合,448,213,26976
2017,上海,综合,447,250,27226
2017,上海,综合,446,239,27465
2017,上海,综合,445,215,27680
2017,上海,综合,444,207,27887
2017,上海,综合,443,229,28116
2017,上海,综合,442,224,28340
2017,上海,综合,441,224,28564
2017,上海,综合,440,201,28765
2017,上海,综合,439,221,28986
2017,上海,综合,438,230,29216
2017,上海,综合,437,206,29422
2017,上海,综合,436,194,29616
2017,上海,综合,435,215,29831
2017,上海,综合,434,203,30034
2017,上海,综合,433,193,30227
2017,上海,综合,432,185,30412
2017,上海,综合,431,201,30613
2017,上海,综合,430,213,30826
2017,上海,综合,429,197,31023
2017,上海,综合,428,189,31212
2017,上海,综合,427,188,31400
2017,上海,综合,426,173,31573
2017,上海,综合,425,179,31752
2017,上海,综合,424,180,31932
2017,上海,综合,423,181,32113
2017,上海,综合,422,170,32283
2017,上海,综合,421,169,32452
2017,上海,综合,420,184,32636
2017,上海,综合,419,183,32819
2017,上海,综合,418,183,33002
2017,上海,综合,417,160,33162
2017,上海,综合,416,171,33333
2017,上海,综合,415,176,33509
2017,上海,综合,414,188,33697
2017,上海,综合,413,173,33870
2017,上海,综合,412,189,34059
2017,上海,综合,411,171,34230
2017,上海,综合,410,146,34376
2017,上海,综合,409,152,34528
2017,上海,综合,408,145,34673
2017,上海,综合,407,175,34848
2017,上海,综合,406,152,35000
2017,上海,综合,405,148,35148
2017,上海,综合,404,164,35312
2017,上海,综合,403,173,35485
2017,上海,综合,402,164,35649
2017,上海,综合,401,170,35819
2017,上海,综合,400,164,35983
2017,上海,综合,399,160,36143
2017,上海,综合,398,131,36274
2017,上海,综合,397,134,36408
2017,上海,综合,396,149,36557
2017,上海,综合,395,137,36694
2017,上海,综合,394,139,36833
2017,上海,综合,393,141,36974
2017,上海,综合,392,125,37099
2017,上海,综合,391,116,37215
2017,上海,综合,390,146,37361
2017,上海,综合,389,127,37488
2017,上海,综合,388,136,37624
2017,上海,综合,387,134,37758
2017,上海,综合,386,117,37875
2017,上海,综合,385,120,37995
2017,上海,综合,384,115,38110
2017,上海,综合,383,120,38230
2017,上海,综合,382,84,38314
2017,上海,综合,381,105,38419
2017,上海,综合,380,100,38519
2017,上海,综合,379,108,38627
2017,上海,综合,378,112,38739
2017,上海,综合,377,92,38831
2017,上海,综合,376,104,38935
2017,上海,综合,375,113,39048
2017,上海,综合,374,113,39161
2017,上海,综合,373,106,39267
2017,上海,综合,372,101,39368
2017,上海,综合,371,101,39469
2017,上海,综合,370,90,39559
2017,上海,综合,369,98,39657
2017,上海,综合,368,87,39744
2017,上海,综合,367,70,39814
2017,上海,综合,366,102,39916
2017,上海,综合,365,87,40003
2017,上海,综合,364,86,40089
2017,上海,综合,363,71,40160
2017,上海,综合,362,88,40248
2017,上海,综合,361,106,40354
2017,上海,综合,360,92,40446
2017,上海,综合,359,70,40516
2017,上海,综合,358,68,40584
2017,上海,综合,357,70,40654
2017,上海,综合,356,82,40736
2017,上海,综合,355,81,40817
2017,上海,综合,354,73,40890
2017,上海,综合,353,59,40949
2017,上海,综合,352,71,41020
2017,上海,综合,351,62,41082
2017,上海,综合,350,49,41131
2017,上海,综合,349,67,41198
2017,上海,综合,348,55,41253
2017,上海,综合,347,53,41306
2017,上海,综合,346,64,41370
2017,上海,综合,345,69,41439
2017,上海,综合,344,40,41479
2017,上海,综合,343,57,41536
2017,上海,综合,342,51,41587
2017,上海,综合,341,58,41645
2017,上海,综合,340,46,41691
2017,上海,综合,339,44,41735
2017,上海,综合,338,41,41776
2017,上海,综合,337,41,41817
2017,上海,综合,336,49,41866
2017,上海,综合,335,57,41923
2017,上海,综合,334,35,41958
2017,上海,综合,333,51,42009
2017,上海,综合,332,43,42052
2017,上海,综合,331,35,42087
2017,上海,综合,330,39,42126
2017,上海,综合,329,41,42167
2017,上海,综合,328,45,42212
2017,上海,综合,327,30,42242
2017,上海,综合,326,24,42266
2017,上海,综合,325,28,42294
2017,上海,综合,324,27,42321
2017,上海,综合,323,20,42341
2017,上海,综合,322,30,42371
2017,上海,综合,321,27,42398
2017,上海,综合,320,35,42433
2017,上海,综合,319,25,42458
2017,上海,综合,318,23,42481
2017,上海,综合,317,20,42501
2017,上海,综合,316,25,42526
2017,上海,综合,315,17,42543
2017,上海,综合,314,14,42557
2017,上海,综合,313,11,42568
2017,上海,综合,312,15,42583
2017,上海,综合,311,23,42606
2017,上海,综合,310,12,42618
2017,上海,综合,309,20,42638
2017,上海,综合,308,27,42665
2017,上海,综合,307,17,42682
2017,上海,综合,306,7,42689
2017,上海,综合,305,10,42699
2017,上海,综合,304,14,42713
2017,上海,综合,303,16,42729
2017,上海,综合,302,15,42744
2017,上海,综合,301,14,42758
2017,上海,综合,300,11,42769
2017,上海,综合,299,16,42785
2017,上海,综合,298,15,42800
2017,上海,综合,297,13,42813
2017,上海,综合,296,13,42826
2017,上海,综合,295,12,42838
2017,上海,综合,294,8,42846
2017,上海,综合,293,7,42853
2017,上海,综合,292,10,42863
2017,上海,综合,291,10,42873
2017,上海,综合,290,9,42882
2017,上海,综合,289,11,42893
2017,上海,综合,288,8,42901
2017,上海,综合,287,13,42914
2017,上海,综合,286,10,42924
2017,上海,综合,285,4,42928
2017,上海,综合,284,5,42933
2017,上海,综合,283,9,42942
2017,上海,综合,282,7,42949
2017,上海,综合,281,15,42964
2017,上海,综合,280,10,42974
2017,上海,综合,279,3,42977
2017,上海,综合,278,7,42984
2017,上海,综合,277,5,42989
2017,上海,综合,276,9,42998
2017,上海,综合,275,9,43007
2017,上海,综合,274,8,43015
2017,上海,综合,273,11,43026
2017,上海,综合,272,5,43031
2017,上海,综合,271,8,43039
2017,上海,综合,270,10,43049
2017,上海,综合,269,7,43056
2017,上海,综合,268,8,43064
2017,上海,综合,267,6,43070
2017,上海,综合,266,5,43075
2017,上海,综合,265,5,43080
2017,上海,综合,264,5,43085
2017,上海,综合,263,9,43094
2017,上海,综合,262,3,43097
2017,上海,综合,261,6,43103
