年份,考生所在地,考生类别,分数段,本段人数,累计人数
2019,浙江,综合,695分及以上,32,330
2019,浙江,综合,694,38,368
2019,浙江,综合,693,53,421
2019,浙江,综合,692,59,480
2019,浙江,综合,691,50,530
2019,浙江,综合,690,79,609
2019,浙江,综合,689,73,682
2019,浙江,综合,688,85,767
2019,浙江,综合,687,77,844
2019,浙江,综合,686,80,924
2019,浙江,综合,685,86,1010
2019,浙江,综合,684,90,1100
2019,浙江,综合,683,103,1203
2019,浙江,综合,682,122,1325
2019,浙江,综合,681,128,1453
2019,浙江,综合,680,113,1566
2019,浙江,综合,679,171,1737
2019,浙江,综合,678,138,1875
2019,浙江,综合,677,133,2008
2019,浙江,综合,676,165,2173
2019,浙江,综合,675,186,2359
2019,浙江,综合,674,201,2560
2019,浙江,综合,673,204,2764
2019,浙江,综合,672,215,2979
2019,浙江,综合,671,194,3173
2019,浙江,综合,670,184,3357
2019,浙江,综合,669,220,3577
2019,浙江,综合,668,253,3830
2019,浙江,综合,667,277,4107
2019,浙江,综合,666,253,4360
2019,浙江,综合,665,294,4654
2019,浙江,综合,664,269,4923
2019,浙江,综合,663,318,5241
2019,浙江,综合,662,303,5544
2019,浙江,综合,661,306,5850
2019,浙江,综合,660,341,6191
2019,浙江,综合,659,343,6534
2019,浙江,综合,658,364,6898
2019,浙江,综合,657,387,7285
2019,浙江,综合,656,341,7626
2019,浙江,综合,655,392,8018
2019,浙江,综合,654,410,8428
2019,浙江,综合,653,428,8856
2019,浙江,综合,652,409,9265
2019,浙江,综合,651,453,9718
2019,浙江,综合,650,486,10204
2019,浙江,综合,649,470,10674
2019,浙江,综合,648,460,11134
2019,浙江,综合,647,456,11590
2019,浙江,综合,646,517,12107
2019,浙江,综合,645,524,12631
2019,浙江,综合,644,522,13153
2019,浙江,综合,643,501,13654
2019,浙江,综合,642,544,14198
2019,浙江,综合,641,573,14771
2019,浙江,综合,640,618,15389
2019,浙江,综合,639,541,15930
2019,浙江,综合,638,599,16529
2019,浙江,综合,637,639,17168
2019,浙江,综合,636,599,17767
2019,浙江,综合,635,645,18412
2019,浙江,综合,634,672,19084
2019,浙江,综合,633,648,19732
2019,浙江,综合,632,663,20395
2019,浙江,综合,631,681,21076
2019,浙江,综合,630,699,21775
2019,浙江,综合,629,695,22470
2019,浙江,综合,628,732,23202
2019,浙江,综合,627,737,23939
2019,浙江,综合,626,760,24699
2019,浙江,综合,625,776,25475
2019,浙江,综合,624,763,26238
2019,浙江,综合,623,778,27016
2019,浙江,综合,622,763,27779
2019,浙江,综合,621,868,28647
2019,浙江,综合,620,800,29447
2019,浙江,综合,619,877,30324
2019,浙江,综合,618,839,31163
2019,浙江,综合,617,879,32042
2019,浙江,综合,616,872,32914
2019,浙江,综合,615,921,33835
2019,浙江,综合,614,844,34679
2019,浙江,综合,613,860,35539
2019,浙江,综合,612,912,36451
2019,浙江,综合,611,861,37312
2019,浙江,综合,610,930,38242
2019,浙江,综合,609,949,39191
2019,浙江,综合,608,1021,40212
2019,浙江,综合,607,976,41188
2019,浙江,综合,606,975,42163
2019,浙江,综合,605,962,43125
2019,浙江,综合,604,957,44082
2019,浙江,综合,603,994,45076
2019,浙江,综合,602,1017,46093
2019,浙江,综合,601,1019,47112
2019,浙江,综合,600,995,48107
2019,浙江,综合,599,1004,49111
2019,浙江,综合,598,1010,50121
2019,浙江,综合,597,1010,51131
2019,浙江,综合,596,1068,52199
2019,浙江,综合,595,1026,53225
2019,浙江,综合,594,1038,54263
2019,浙江,综合,593,1057,55320
2019,浙江,综合,592,1070,56390
2019,浙江,综合,591,1053,57443
2019,浙江,综合,590,1034,58477
2019,浙江,综合,589,1036,59513
2019,浙江,综合,588,1076,60589
2019,浙江,综合,587,1044,61633
2019,浙江,综合,586,1065,62698
2019,浙江,综合,585,1096,63794
2019,浙江,综合,584,1144,64938
2019,浙江,综合,583,1153,66091
2019,浙江,综合,582,1062,67153
2019,浙江,综合,581,1105,68258
2019,浙江,综合,580,1091,69349
2019,浙江,综合,579,1111,70460
2019,浙江,综合,578,1096,71556
2019,浙江,综合,577,1119,72675
2019,浙江,综合,576,1149,73824
2019,浙江,综合,575,1056,74880
2019,浙江,综合,574,1103,75983
2019,浙江,综合,573,1112,77095
2019,浙江,综合,572,1131,78226
2019,浙江,综合,571,1064,79290
2019,浙江,综合,570,1125,80415
2019,浙江,综合,569,1122,81537
2019,浙江,综合,568,1095,82632
2019,浙江,综合,567,1046,83678
2019,浙江,综合,566,1105,84783
2019,浙江,综合,565,1142,85925
2019,浙江,综合,564,1107,87032
2019,浙江,综合,563,1108,88140
2019,浙江,综合,562,1087,89227
2019,浙江,综合,561,1092,90319
2019,浙江,综合,560,1054,91373
2019,浙江,综合,559,1121,92494
2019,浙江,综合,558,1104,93598
2019,浙江,综合,557,1108,94706
2019,浙江,综合,556,1097,95803
2019,浙江,综合,555,1080,96883
2019,浙江,综合,554,1095,97978
2019,浙江,综合,553,1068,99046
2019,浙江,综合,552,1081,100127
2019,浙江,综合,551,1129,101256
2019,浙江,综合,550,1108,102364
2019,浙江,综合,549,1114,103478
2019,浙江,综合,548,1111,104589
2019,浙江,综合,547,1082,105671
2019,浙江,综合,546,1091,106762
2019,浙江,综合,545,1060,107822
2019,浙江,综合,544,1039,108861
2019,浙江,综合,543,1085,109946
2019,浙江,综合,542,1139,111085
2019,浙江,综合,541,1096,112181
2019,浙江,综合,540,1166,113347
2019,浙江,综合,539,1088,114435
2019,浙江,综合,538,1050,115485
2019,浙江,综合,537,1139,116624
2019,浙江,综合,536,1090,117714
2019,浙江,综合,535,1094,118808
2019,浙江,综合,534,1126,119934
2019,浙江,综合,533,1130,121064
2019,浙江,综合,532,1072,122136
2019,浙江,综合,531,1124,123260
2019,浙江,综合,530,1101,124361
2019,浙江,综合,529,1058,125419
2019,浙江,综合,528,1066,126485
2019,浙江,综合,527,1183,127668
2019,浙江,综合,526,1076,128744
2019,浙江,综合,525,1053,129797
2019,浙江,综合,524,1055,130852
2019,浙江,综合,523,1061,131913
2019,浙江,综合,522,1072,132985
2019,浙江,综合,521,1084,134069
2019,浙江,综合,520,1055,135124
2019,浙江,综合,519,1087,136211
2019,浙江,综合,518,1125,137336
2019,浙江,综合,517,1086,138422
2019,浙江,综合,516,1012,139434
2019,浙江,综合,515,1081,140515
2019,浙江,综合,514,1013,141528
2019,浙江,综合,513,1012,142540
2019,浙江,综合,512,1052,143592
2019,浙江,综合,511,1041,144633
2019,浙江,综合,510,996,145629
2019,浙江,综合,509,1002,146631
2019,浙江,综合,508,1036,147667
2019,浙江,综合,507,1002,148669
2019,浙江,综合,506,1088,149757
2019,浙江,综合,505,1009,150766
2019,浙江,综合,504,1066,151832
2019,浙江,综合,503,1027,152859
2019,浙江,综合,502,1052,153911
2019,浙江,综合,501,1065,154976
2019,浙江,综合,500,1000,155976
2019,浙江,综合,499,952,156928
2019,浙江,综合,498,976,157904
2019,浙江,综合,497,1013,158917
2019,浙江,综合,496,1004,159921
2019,浙江,综合,495,935,160856
2019,浙江,综合,494,969,161825
2019,浙江,综合,493,924,162749
2019,浙江,综合,492,924,163673
2019,浙江,综合,491,934,164607
2019,浙江,综合,490,948,165555
2019,浙江,综合,489,952,166507
2019,浙江,综合,488,937,167444
2019,浙江,综合,487,924,168368
2019,浙江,综合,486,896,169264
2019,浙江,综合,485,857,170121
2019,浙江,综合,484,921,171042
2019,浙江,综合,483,880,171922
2019,浙江,综合,482,912,172834
2019,浙江,综合,481,938,173772
2019,浙江,综合,480,834,174606
2019,浙江,综合,479,886,175492
2019,浙江,综合,478,856,176348
2019,浙江,综合,477,877,177225
2019,浙江,综合,476,901,178126
2019,浙江,综合,475,822,178948
2019,浙江,综合,474,829,179777
2019,浙江,综合,473,886,180663
2019,浙江,综合,472,821,181484
2019,浙江,综合,471,825,182309
2019,浙江,综合,470,798,183107
2019,浙江,综合,469,795,183902
2019,浙江,综合,468,772,184674
2019,浙江,综合,467,887,185561
2019,浙江,综合,466,835,186396
2019,浙江,综合,465,826,187222
2019,浙江,综合,464,774,187996
2019,浙江,综合,463,823,188819
2019,浙江,综合,462,738,189557
2019,浙江,综合,461,741,190298
2019,浙江,综合,460,757,191055
2019,浙江,综合,459,745,191800
2019,浙江,综合,458,740,192540
2019,浙江,综合,457,720,193260
2019,浙江,综合,456,714,193974
2019,浙江,综合,455,696,194670
2019,浙江,综合,454,730,195400
2019,浙江,综合,453,695,196095
2019,浙江,综合,452,699,196794
2019,浙江,综合,451,666,197460
2019,浙江,综合,450,704,198164
2019,浙江,综合,449,626,198790
2019,浙江,综合,448,704,199494
2019,浙江,综合,447,657,200151
2019,浙江,综合,446,679,200830
2019,浙江,综合,445,656,201486
2019,浙江,综合,444,618,202104
2019,浙江,综合,443,686,202790
2019,浙江,综合,442,676,203466
2019,浙江,综合,441,603,204069
2019,浙江,综合,440,584,204653
2019,浙江,综合,439,625,205278
2019,浙江,综合,438,631,205909
2019,浙江,综合,437,642,206551
2019,浙江,综合,436,618,207169
2019,浙江,综合,435,631,207800
2019,浙江,综合,434,566,208366
2019,浙江,综合,433,598,208964
2019,浙江,综合,432,559,209523
2019,浙江,综合,431,629,210152
2019,浙江,综合,430,574,210726
2019,浙江,综合,429,580,211306
2019,浙江,综合,428,538,211844
2019,浙江,综合,427,520,212364
2019,浙江,综合,426,545,212909
2019,浙江,综合,425,531,213440
2019,浙江,综合,424,512,213952
2019,浙江,综合,423,523,214475
2019,浙江,综合,422,497,214972
2019,浙江,综合,421,517,215489
2019,浙江,综合,420,527,216016
2019,浙江,综合,419,539,216555
2019,浙江,综合,418,506,217061
2019,浙江,综合,417,492,217553
2019,浙江,综合,416,529,218082
2019,浙江,综合,415,498,218580
2019,浙江,综合,414,496,219076
2019,浙江,综合,413,476,219552
2019,浙江,综合,412,492,220044
2019,浙江,综合,411,476,220520
2019,浙江,综合,410,508,221028
2019,浙江,综合,409,476,221504
2019,浙江,综合,408,434,221938
2019,浙江,综合,407,474,222412
2019,浙江,综合,406,428,222840
2019,浙江,综合,405,436,223276
2019,浙江,综合,404,421,223697
2019,浙江,综合,403,396,224093
2019,浙江,综合,402,388,224481
2019,浙江,综合,401,395,224876
2019,浙江,综合,400,422,225298
2019,浙江,综合,399,379,225677
2019,浙江,综合,398,396,226073
2019,浙江,综合,397,416,226489
2019,浙江,综合,396,402,226891
2019,浙江,综合,395,397,227288
2019,浙江,综合,394,375,227663
2019,浙江,综合,393,374,228037
2019,浙江,综合,392,346,228383
2019,浙江,综合,391,341,228724
2019,浙江,综合,390,353,229077
2019,浙江,综合,389,381,229458
2019,浙江,综合,388,348,229806
2019,浙江,综合,387,345,230151
2019,浙江,综合,386,348,230499
2019,浙江,综合,385,320,230819
2019,浙江,综合,384,316,231135
2019,浙江,综合,383,315,231450
2019,浙江,综合,382,337,231787
2019,浙江,综合,381,323,232110
2019,浙江,综合,380,317,232427
2019,浙江,综合,379,343,232770
2019,浙江,综合,378,303,233073
2019,浙江,综合,377,279,233352
2019,浙江,综合,376,293,233645
2019,浙江,综合,375,293,233938
2019,浙江,综合,374,281,234219
2019,浙江,综合,373,296,234515
2019,浙江,综合,372,278,234793
2019,浙江,综合,371,277,235070
2019,浙江,综合,370,296,235366
2019,浙江,综合,369,275,235641
2019,浙江,综合,368,279,235920
2019,浙江,综合,367,268,236188
2019,浙江,综合,366,257,236445
2019,浙江,综合,365,275,236720
2019,浙江,综合,364,253,236973
2019,浙江,综合,363,223,237196
2019,浙江,综合,362,242,237438
2019,浙江,综合,361,266,237704
2019,浙江,综合,360,229,237933
2019,浙江,综合,359,224,238157
2019,浙江,综合,358,242,238399
2019,浙江,综合,357,255,238654
2019,浙江,综合,356,229,238883
2019,浙江,综合,355,200,239083
2019,浙江,综合,354,215,239298
2019,浙江,综合,353,188,239486
2019,浙江,综合,352,198,239684
2019,浙江,综合,351,199,239883
2019,浙江,综合,350,203,240086
2019,浙江,综合,349,177,240263
2019,浙江,综合,348,185,240448
2019,浙江,综合,347,200,240648
2019,浙江,综合,346,190,240838
2019,浙江,综合,345,175,241013
2019,浙江,综合,344,193,241206
2019,浙江,综合,343,181,241387
2019,浙江,综合,342,168,241555
2019,浙江,综合,341,168,241723
2019,浙江,综合,340,141,241864
2019,浙江,综合,339,167,242031
2019,浙江,综合,338,146,242177
2019,浙江,综合,337,161,242338
2019,浙江,综合,336,170,242508
2019,浙江,综合,335,135,242643
2019,浙江,综合,334,137,242780
2019,浙江,综合,333,157,242937
2019,浙江,综合,332,133,243070
2019,浙江,综合,331,138,243208
2019,浙江,综合,330,141,243349
2019,浙江,综合,329,139,243488
2019,浙江,综合,328,94,243582
2019,浙江,综合,327,104,243686
2019,浙江,综合,326,120,243806
2019,浙江,综合,325,115,243921
2019,浙江,综合,324,118,244039
2019,浙江,综合,323,113,244152
2019,浙江,综合,322,111,244263
2019,浙江,综合,321,112,244375
2019,浙江,综合,320,109,244484
2019,浙江,综合,319,126,244610
2019,浙江,综合,318,92,244702
2019,浙江,综合,317,95,244797
2019,浙江,综合,316,117,244914
2019,浙江,综合,315,105,245019
2019,浙江,综合,314,101,245120
2019,浙江,综合,313,89,245209
2019,浙江,综合,312,89,245298
2019,浙江,综合,311,110,245408
2019,浙江,综合,310,97,245505
2019,浙江,综合,309,106,245611
2019,浙江,综合,308,100,245711
2019,浙江,综合,307,91,245802
2019,浙江,综合,306,88,245890
2019,浙江,综合,305,93,245983
2019,浙江,综合,304,103,246086
2019,浙江,综合,303,97,246183
2019,浙江,综合,302,108,246291
2019,浙江,综合,301,108,246399
2019,浙江,综合,300,94,246493
2019,浙江,综合,299,93,246586
2019,浙江,综合,298,108,246694
2019,浙江,综合,297,115,246809
2019,浙江,综合,296,97,246906
2019,浙江,综合,295,110,247016
2019,浙江,综合,294,90,247106
2019,浙江,综合,293,129,247235
2019,浙江,综合,292,128,247363
2019,浙江,综合,291,137,247500
2019,浙江,综合,290,134,247634
2019,浙江,综合,289,127,247761
2019,浙江,综合,288,131,247892
2019,浙江,综合,287,128,248020
2019,浙江,综合,286,152,248172
2019,浙江,综合,285,147,248319
2019,浙江,综合,284,151,248470
2019,浙江,综合,283,134,248604
2019,浙江,综合,282,145,248749
2019,浙江,综合,281,155,248904
2019,浙江,综合,280,161,249065
2019,浙江,综合,279,169,249234
2019,浙江,综合,278,172,249406
2019,浙江,综合,277,166,249572
2019,浙江,综合,276,182,249754
2019,浙江,综合,275,170,249924
2019,浙江,综合,274,168,250092
2019,浙江,综合,273,176,250268
2019,浙江,综合,272,198,250466
2019,浙江,综合,271,181,250647
2019,浙江,综合,270,202,250849
2019,浙江,综合,269,192,251041
2019,浙江,综合,268,217,251258
2019,浙江,综合,267,205,251463
2019,浙江,综合,266,199,251662
2019,浙江,综合,265,207,251869
2019,浙江,综合,264,186,252055
2018,浙江,综合,688分及以上,325,325
2018,浙江,综合,687,42,367
2018,浙江,综合,686,49,416
2018,浙江,综合,685,54,470
2018,浙江,综合,684,57,527
2018,浙江,综合,683,47,574
2018,浙江,综合,682,51,625
2018,浙江,综合,681,68,693
2018,浙江,综合,680,81,774
2018,浙江,综合,679,73,847
2018,浙江,综合,678,100,947
2018,浙江,综合,677,81,1028
2018,浙江,综合,676,104,1132
2018,浙江,综合,675,97,1229
2018,浙江,综合,674,98,1327
2018,浙江,综合,673,123,1450
2018,浙江,综合,672,140,1590
2018,浙江,综合,671,130,1720
2018,浙江,综合,670,165,1885
2018,浙江,综合,669,162,2047
2018,浙江,综合,668,165,2212
2018,浙江,综合,667,157,2369
2018,浙江,综合,666,158,2527
2018,浙江,综合,665,188,2715
2018,浙江,综合,664,202,2917
2018,浙江,综合,663,229,3146
2018,浙江,综合,662,228,3374
2018,浙江,综合,661,255,3629
2018,浙江,综合,660,232,3861
2018,浙江,综合,659,234,4095
2018,浙江,综合,658,250,4345
2018,浙江,综合,657,275,4620
2018,浙江,综合,656,291,4911
2018,浙江,综合,655,315,5226
2018,浙江,综合,654,299,5525
2018,浙江,综合,653,313,5838
2018,浙江,综合,652,327,6165
2018,浙江,综合,651,339,6504
2018,浙江,综合,650,365,6869
2018,浙江,综合,649,348,7217
2018,浙江,综合,648,372,7589
2018,浙江,综合,647,362,7951
2018,浙江,综合,646,425,8376
2018,浙江,综合,645,438,8814
2018,浙江,综合,644,431,9245
2018,浙江,综合,643,442,9687
2018,浙江,综合,642,476,10163
2018,浙江,综合,641,488,10651
2018,浙江,综合,640,470,11121
2018,浙江,综合,639,459,11580
2018,浙江,综合,638,487,12067
2018,浙江,综合,637,540,12607
2018,浙江,综合,636,548,13155
2018,浙江,综合,635,528,13683
2018,浙江,综合,634,575,14258
2018,浙江,综合,633,550,14808
2018,浙江,综合,632,611,15419
2018,浙江,综合,631,626,16045
2018,浙江,综合,630,638,16683
2018,浙江,综合,629,660,17343
2018,浙江,综合,628,630,17973
2018,浙江,综合,627,679,18652
2018,浙江,综合,626,665,19317
2018,浙江,综合,625,654,19971
2018,浙江,综合,624,698,20669
2018,浙江,综合,623,719,21388
2018,浙江,综合,622,749,22137
2018,浙江,综合,621,744,22881
2018,浙江,综合,620,797,23678
2018,浙江,综合,619,764,24442
2018,浙江,综合,618,734,25176
2018,浙江,综合,617,830,26006
2018,浙江,综合,616,818,26824
2018,浙江,综合,615,824,27648
2018,浙江,综合,614,827,28475
2018,浙江,综合,613,832,29307
2018,浙江,综合,612,787,30094
2018,浙江,综合,611,858,30952
2018,浙江,综合,610,881,31833
2018,浙江,综合,609,851,32684
2018,浙江,综合,608,887,33571
2018,浙江,综合,607,930,34501
2018,浙江,综合,606,888,35389
2018,浙江,综合,605,899,36288
2018,浙江,综合,604,910,37198
2018,浙江,综合,603,926,38124
2018,浙江,综合,602,958,39082
2018,浙江,综合,601,974,40056
2018,浙江,综合,600,974,41030
2018,浙江,综合,599,962,41992
2018,浙江,综合,598,931,42923
2018,浙江,综合,597,948,43871
2018,浙江,综合,596,1010,44881
2018,浙江,综合,595,1022,45903
2018,浙江,综合,594,1007,46910
2018,浙江,综合,593,1026,47936
2018,浙江,综合,592,1044,48980
2018,浙江,综合,591,977,49957
2018,浙江,综合,590,1085,51042
2018,浙江,综合,589,1030,52072
2018,浙江,综合,588,1069,53141
2018,浙江,综合,587,1075,54216
2018,浙江,综合,586,1123,55339
2018,浙江,综合,585,1159,56498
2018,浙江,综合,584,1101,57599
2018,浙江,综合,583,1093,58692
2018,浙江,综合,582,1134,59826
2018,浙江,综合,581,1120,60946
2018,浙江,综合,580,1084,62030
2018,浙江,综合,579,1099,63129
2018,浙江,综合,578,1044,64173
2018,浙江,综合,577,1072,65245
2018,浙江,综合,576,1050,66295
2018,浙江,综合,575,1101,67396
2018,浙江,综合,574,1072,68468
2018,浙江,综合,573,1128,69596
2018,浙江,综合,572,1098,70694
2018,浙江,综合,571,1068,71762
2018,浙江,综合,570,1115,72877
2018,浙江,综合,569,1113,73990
2018,浙江,综合,568,1143,75133
2018,浙江,综合,567,1084,76217
2018,浙江,综合,566,1068,77285
2018,浙江,综合,565,1041,78326
2018,浙江,综合,564,1167,79493
2018,浙江,综合,563,1131,80624
2018,浙江,综合,562,1117,81741
2018,浙江,综合,561,1100,82841
2018,浙江,综合,560,1116,83957
2018,浙江,综合,559,1096,85053
2018,浙江,综合,558,1111,86164
2018,浙江,综合,557,1097,87261
2018,浙江,综合,556,1044,88305
2018,浙江,综合,555,1080,89385
2018,浙江,综合,554,1042,90427
2018,浙江,综合,553,1013,91440
2018,浙江,综合,552,1101,92541
2018,浙江,综合,551,1112,93653
2018,浙江,综合,550,1141,94794
2018,浙江,综合,549,1089,95883
2018,浙江,综合,548,1079,96962
2018,浙江,综合,547,1110,98072
2018,浙江,综合,546,1075,99147
2018,浙江,综合,545,1059,100206
2018,浙江,综合,544,1087,101293
2018,浙江,综合,543,1030,102323
2018,浙江,综合,542,1093,103416
2018,浙江,综合,541,1114,104530
2018,浙江,综合,540,1109,105639
2018,浙江,综合,539,1081,106720
2018,浙江,综合,538,1031,107751
2018,浙江,综合,537,1014,108765
2018,浙江,综合,536,1008,109773
2018,浙江,综合,535,1069,110842
2018,浙江,综合,534,1063,111905
2018,浙江,综合,533,1102,113007
2018,浙江,综合,532,1064,114071
2018,浙江,综合,531,989,115060
2018,浙江,综合,530,1033,116093
2018,浙江,综合,529,1000,117093
2018,浙江,综合,528,1051,118144
2018,浙江,综合,527,1099,119243
2018,浙江,综合,526,1094,120337
2018,浙江,综合,525,1075,121412
2018,浙江,综合,524,1043,122455
2018,浙江,综合,523,1108,123563
2018,浙江,综合,522,1047,124610
2018,浙江,综合,521,1051,125661
2018,浙江,综合,520,1082,126743
2018,浙江,综合,519,1046,127789
2018,浙江,综合,518,1055,128844
2018,浙江,综合,517,1027,129871
2018,浙江,综合,516,1048,130919
2018,浙江,综合,515,1029,131948
2018,浙江,综合,514,1030,132978
2018,浙江,综合,513,1047,134025
2018,浙江,综合,512,1046,135071
2018,浙江,综合,511,1046,136117
2018,浙江,综合,510,1064,137181
2018,浙江,综合,509,1044,138225
2018,浙江,综合,508,959,139184
2018,浙江,综合,507,1046,140230
2018,浙江,综合,506,989,141219
2018,浙江,综合,505,998,142217
2018,浙江,综合,504,955,143172
2018,浙江,综合,503,1019,144191
2018,浙江,综合,502,1005,145196
2018,浙江,综合,501,969,146165
2018,浙江,综合,500,1008,147173
2018,浙江,综合,499,1032,148205
2018,浙江,综合,498,971,149176
2018,浙江,综合,497,1027,150203
2018,浙江,综合,496,985,151188
2018,浙江,综合,495,972,152160
2018,浙江,综合,494,937,153097
2018,浙江,综合,493,963,154060
2018,浙江,综合,492,924,154984
2018,浙江,综合,491,933,155917
2018,浙江,综合,490,968,156885
2018,浙江,综合,489,942,157827
2018,浙江,综合,488,910,158737
2018,浙江,综合,487,925,159662
2018,浙江,综合,486,913,160575
2018,浙江,综合,485,975,161550
2018,浙江,综合,484,864,162414
2018,浙江,综合,483,956,163370
2018,浙江,综合,482,925,164295
2018,浙江,综合,481,861,165156
2018,浙江,综合,480,871,166027
2018,浙江,综合,479,868,166895
2018,浙江,综合,478,906,167801
2018,浙江,综合,477,871,168672
2018,浙江,综合,476,891,169563
2018,浙江,综合,475,874,170437
2018,浙江,综合,474,830,171267
2018,浙江,综合,473,855,172122
2018,浙江,综合,472,864,172986
2018,浙江,综合,471,832,173818
2018,浙江,综合,470,855,174673
2018,浙江,综合,469,809,175482
2018,浙江,综合,468,800,176282
2018,浙江,综合,467,820,177102
2018,浙江,综合,466,858,177960
2018,浙江,综合,465,802,178762
2018,浙江,综合,464,814,179576
2018,浙江,综合,463,792,180368
2018,浙江,综合,462,788,181156
2018,浙江,综合,461,805,181961
2018,浙江,综合,460,748,182709
2018,浙江,综合,459,791,183500
2018,浙江,综合,458,766,184266
2018,浙江,综合,457,759,185025
2018,浙江,综合,456,748,185773
2018,浙江,综合,455,725,186498
2018,浙江,综合,454,745,187243
2018,浙江,综合,453,724,187967
2018,浙江,综合,452,734,188701
2018,浙江,综合,451,720,189421
2018,浙江,综合,450,679,190100
2018,浙江,综合,449,702,190802
2018,浙江,综合,448,705,191507
2018,浙江,综合,447,736,192243
2018,浙江,综合,446,700,192943
2018,浙江,综合,445,695,193638
2018,浙江,综合,444,685,194323
2018,浙江,综合,443,720,195043
2018,浙江,综合,442,648,195691
2018,浙江,综合,441,618,196309
2018,浙江,综合,440,660,196969
2018,浙江,综合,439,652,197621
2018,浙江,综合,438,655,198276
2018,浙江,综合,437,625,198901
2018,浙江,综合,436,603,199504
2018,浙江,综合,435,619,200123
2018,浙江,综合,434,607,200730
2018,浙江,综合,433,610,201340
2018,浙江,综合,432,590,201930
2018,浙江,综合,431,616,202546
2018,浙江,综合,430,539,203085
2018,浙江,综合,429,570,203655
2018,浙江,综合,428,584,204239
2018,浙江,综合,427,567,204806
2018,浙江,综合,426,555,205361
2018,浙江,综合,425,552,205913
2018,浙江,综合,424,559,206472
2018,浙江,综合,423,535,207007
2018,浙江,综合,422,547,207554
2018,浙江,综合,421,521,208075
2018,浙江,综合,420,537,208612
2018,浙江,综合,419,502,209114
2018,浙江,综合,418,520,209634
2018,浙江,综合,417,496,210130
2018,浙江,综合,416,502,210632
2018,浙江,综合,415,478,211110
2018,浙江,综合,414,499,211609
2018,浙江,综合,413,462,212071
2018,浙江,综合,412,450,212521
2018,浙江,综合,411,529,213050
2018,浙江,综合,410,475,213525
2018,浙江,综合,409,438,213963
2018,浙江,综合,408,456,214419
2018,浙江,综合,407,455,214874
2018,浙江,综合,406,468,215342
2018,浙江,综合,405,437,215779
2018,浙江,综合,404,422,216201
2018,浙江,综合,403,414,216615
2018,浙江,综合,402,437,217052
2018,浙江,综合,401,409,217461
2018,浙江,综合,400,389,217850
2018,浙江,综合,399,376,218226
2018,浙江,综合,398,398,218624
2018,浙江,综合,397,387,219011
2018,浙江,综合,396,412,219423
2018,浙江,综合,395,375,219798
2018,浙江,综合,394,385,220183
2018,浙江,综合,393,382,220565
2018,浙江,综合,392,394,220959
2018,浙江,综合,391,370,221329
2018,浙江,综合,390,347,221676
2018,浙江,综合,389,355,222031
2018,浙江,综合,388,385,222416
2018,浙江,综合,387,361,222777
2018,浙江,综合,386,345,223122
2018,浙江,综合,385,326,223448
2018,浙江,综合,384,373,223821
2018,浙江,综合,383,295,224116
2018,浙江,综合,382,354,224470
2018,浙江,综合,381,330,224800
2018,浙江,综合,380,342,225142
2018,浙江,综合,379,335,225477
2018,浙江,综合,378,335,225812
2018,浙江,综合,377,338,226150
2018,浙江,综合,376,319,226469
2018,浙江,综合,375,284,226753
2018,浙江,综合,374,279,227032
2018,浙江,综合,373,286,227318
2018,浙江,综合,372,299,227617
2018,浙江,综合,371,275,227892
2018,浙江,综合,370,289,228181
2018,浙江,综合,369,295,228476
2018,浙江,综合,368,276,228752
2018,浙江,综合,367,284,229036
2018,浙江,综合,366,285,229321
2018,浙江,综合,365,252,229573
2018,浙江,综合,364,264,229837
2018,浙江,综合,363,279,230116
2018,浙江,综合,362,253,230369
2018,浙江,综合,361,244,230613
2018,浙江,综合,360,249,230862
2018,浙江,综合,359,245,231107
2018,浙江,综合,358,225,231332
2018,浙江,综合,357,239,231571
2018,浙江,综合,356,215,231786
2018,浙江,综合,355,235,232021
2018,浙江,综合,354,217,232238
2018,浙江,综合,353,209,232447
2018,浙江,综合,352,221,232668
2018,浙江,综合,351,197,232865
2018,浙江,综合,350,222,233087
2018,浙江,综合,349,213,233300
2018,浙江,综合,348,238,233538
2018,浙江,综合,347,204,233742
2018,浙江,综合,346,218,233960
2018,浙江,综合,345,178,234138
2018,浙江,综合,344,202,234340
2017,浙江,综合,686及以上,318,318
2017,浙江,综合,685,38,356
2017,浙江,综合,684,41,397
2017,浙江,综合,683,48,445
2017,浙江,综合,682,49,494
2017,浙江,综合,681,51,545
2017,浙江,综合,680,62,607
2017,浙江,综合,679,62,669
2017,浙江,综合,678,68,737
2017,浙江,综合,677,84,821
2017,浙江,综合,676,65,886
2017,浙江,综合,675,83,969
2017,浙江,综合,674,82,1051
2017,浙江,综合,673,87,1138
2017,浙江,综合,672,96,1234
2017,浙江,综合,671,72,1306
2017,浙江,综合,670,88,1394
2017,浙江,综合,669,104,1498
2017,浙江,综合,668,124,1622
2017,浙江,综合,667,123,1745
2017,浙江,综合,666,142,1887
2017,浙江,综合,665,104,1991
2017,浙江,综合,664,124,2115
2017,浙江,综合,663,131,2246
2017,浙江,综合,662,151,2397
2017,浙江,综合,661,169,2566
2017,浙江,综合,660,154,2720
2017,浙江,综合,659,153,2873
2017,浙江,综合,658,190,3063
2017,浙江,综合,657,198,3261
2017,浙江,综合,656,195,3456
2017,浙江,综合,655,215,3671
2017,浙江,综合,654,210,3881
2017,浙江,综合,653,207,4088
2017,浙江,综合,652,254,4342
2017,浙江,综合,651,220,4562
2017,浙江,综合,650,228,4790
2017,浙江,综合,649,269,5059
2017,浙江,综合,648,231,5290
2017,浙江,综合,647,272,5562
2017,浙江,综合,646,288,5850
2017,浙江,综合,645,294,6144
2017,浙江,综合,644,296,6440
2017,浙江,综合,643,325,6765
2017,浙江,综合,642,296,7061
2017,浙江,综合,641,300,7361
2017,浙江,综合,640,341,7702
2017,浙江,综合,639,345,8047
2017,浙江,综合,638,357,8404
2017,浙江,综合,637,358,8762
2017,浙江,综合,636,409,9171
2017,浙江,综合,635,352,9523
2017,浙江,综合,634,409,9932
2017,浙江,综合,633,387,10319
2017,浙江,综合,632,398,10717
2017,浙江,综合,631,437,11154
2017,浙江,综合,630,422,11576
2017,浙江,综合,629,441,12017
2017,浙江,综合,628,444,12461
2017,浙江,综合,627,486,12947
2017,浙江,综合,626,515,13462
2017,浙江,综合,625,493,13955
2017,浙江,综合,624,551,14506
2017,浙江,综合,623,571,15077
2017,浙江,综合,622,529,15606
2017,浙江,综合,621,513,16119
2017,浙江,综合,620,569,16688
2017,浙江,综合,619,546,17234
2017,浙江,综合,618,546,17780
2017,浙江,综合,617,597,18377
2017,浙江,综合,616,610,18987
2017,浙江,综合,615,636,19623
2017,浙江,综合,614,605,20228
2017,浙江,综合,613,676,20904
2017,浙江,综合,612,656,21560
2017,浙江,综合,611,662,22222
2017,浙江,综合,610,667,22889
2017,浙江,综合,609,639,23528
2017,浙江,综合,608,688,24216
2017,浙江,综合,607,647,24863
2017,浙江,综合,606,710,25573
2017,浙江,综合,605,734,26307
2017,浙江,综合,604,750,27057
2017,浙江,综合,603,752,27809
2017,浙江,综合,602,765,28574
2017,浙江,综合,601,785,29359
2017,浙江,综合,600,847,30206
2017,浙江,综合,599,838,31044
2017,浙江,综合,598,786,31830
2017,浙江,综合,597,807,32637
2017,浙江,综合,596,757,33394
2017,浙江,综合,595,843,34237
2017,浙江,综合,594,860,35097
2017,浙江,综合,593,888,35985
2017,浙江,综合,592,892,36877
2017,浙江,综合,591,893,37770
2017,浙江,综合,590,881,38651
2017,浙江,综合,589,958,39609
2017,浙江,综合,588,874,40483
2017,浙江,综合,587,930,41413
2017,浙江,综合,586,967,42380
2017,浙江,综合,585,898,43278
2017,浙江,综合,584,909,44187
2017,浙江,综合,583,965,45152
2017,浙江,综合,582,945,46097
2017,浙江,综合,581,951,47048
2017,浙江,综合,580,958,48006
2017,浙江,综合,579,959,48965
2017,浙江,综合,578,912,49877
2017,浙江,综合,577,963,50840
2017,浙江,综合,576,991,51831
2017,浙江,综合,575,1001,52832
2017,浙江,综合,574,986,53818
2017,浙江,综合,573,957,54775
2017,浙江,综合,572,959,55734
2017,浙江,综合,571,1047,56781
2017,浙江,综合,570,1046,57827
2017,浙江,综合,569,1009,58836
2017,浙江,综合,568,1017,59853
2017,浙江,综合,567,1002,60855
2017,浙江,综合,566,955,61810
2017,浙江,综合,565,1049,62859
2017,浙江,综合,564,1012,63871
2017,浙江,综合,563,1045,64916
2017,浙江,综合,562,1050,65966
2017,浙江,综合,561,1038,67004
2017,浙江,综合,560,1046,68050
2017,浙江,综合,559,1004,69054
2017,浙江,综合,558,1014,70068
2017,浙江,综合,557,1043,71111
2017,浙江,综合,556,983,72094
2017,浙江,综合,555,1046,73140
2017,浙江,综合,554,1028,74168
2017,浙江,综合,553,961,75129
2017,浙江,综合,552,1041,76170
2017,浙江,综合,551,1018,77188
2017,浙江,综合,550,1087,78275
2017,浙江,综合,549,1093,79368
2017,浙江,综合,548,1055,80423
2017,浙江,综合,547,1068,81491
2017,浙江,综合,546,1019,82510
2017,浙江,综合,545,1091,83601
2017,浙江,综合,544,1051,84652
2017,浙江,综合,543,1045,85697
2017,浙江,综合,542,1096,86793
2017,浙江,综合,541,1069,87862
2017,浙江,综合,540,1015,88877
2017,浙江,综合,539,1093,89970
2017,浙江,综合,538,1045,91015
2017,浙江,综合,537,1048,92063
2017,浙江,综合,536,1059,93122
2017,浙江,综合,535,1006,94128
2017,浙江,综合,534,1065,95193
2017,浙江,综合,533,1056,96249
2017,浙江,综合,532,1076,97325
2017,浙江,综合,531,1036,98361
2017,浙江,综合,530,1059,99420
2017,浙江,综合,529,1108,100528
2017,浙江,综合,528,1030,101558
2017,浙江,综合,527,1008,102566
2017,浙江,综合,526,991,103557
2017,浙江,综合,525,1060,104617
2017,浙江,综合,524,1043,105660
2017,浙江,综合,523,1061,106721
2017,浙江,综合,522,1093,107814
2017,浙江,综合,521,1063,108877
2017,浙江,综合,520,1021,109898
2017,浙江,综合,519,1042,110940
2017,浙江,综合,518,1083,112023
2017,浙江,综合,517,1120,113143
2017,浙江,综合,516,1065,114208
2017,浙江,综合,515,1057,115265
2017,浙江,综合,514,1027,116292
2017,浙江,综合,513,1046,117338
2017,浙江,综合,512,1040,118378
2017,浙江,综合,511,1048,119426
2017,浙江,综合,510,1045,120471
2017,浙江,综合,509,1009,121480
2017,浙江,综合,508,1021,122501
2017,浙江,综合,507,1044,123545
2017,浙江,综合,506,1009,124554
2017,浙江,综合,505,999,125553
2017,浙江,综合,504,1043,126596
2017,浙江,综合,503,1027,127623
2017,浙江,综合,502,1057,128680
2017,浙江,综合,501,1026,129706
2017,浙江,综合,500,981,130687
2017,浙江,综合,499,1067,131754
2017,浙江,综合,498,1001,132755
2017,浙江,综合,497,992,133747
2017,浙江,综合,496,952,134699
2017,浙江,综合,495,1014,135713
2017,浙江,综合,494,1020,136733
2017,浙江,综合,493,1030,137763
2017,浙江,综合,492,1040,138803
2017,浙江,综合,491,1000,139803
2017,浙江,综合,490,1022,140825
2017,浙江,综合,489,997,141822
2017,浙江,综合,488,995,142817
2017,浙江,综合,487,954,143771
2017,浙江,综合,486,968,144739
2017,浙江,综合,485,1002,145741
2017,浙江,综合,484,986,146727
2017,浙江,综合,483,983,147710
2017,浙江,综合,482,977,148687
2017,浙江,综合,481,978,149665
2017,浙江,综合,480,970,150635
2017,浙江,综合,479,1022,151657
2017,浙江,综合,478,949,152606
2017,浙江,综合,477,919,153525
2017,浙江,综合,476,965,154490
2017,浙江,综合,475,946,155436
2017,浙江,综合,474,903,156339
2017,浙江,综合,473,955,157294
2017,浙江,综合,472,906,158200
2017,浙江,综合,471,941,159141
2017,浙江,综合,470,934,160075
2017,浙江,综合,469,941,161016
2017,浙江,综合,468,875,161891
2017,浙江,综合,467,954,162845
2017,浙江,综合,466,912,163757
2017,浙江,综合,465,909,164666
2017,浙江,综合,464,894,165560
2017,浙江,综合,463,930,166490
2017,浙江,综合,462,910,167400
2017,浙江,综合,461,858,168258
2017,浙江,综合,460,888,169146
2017,浙江,综合,459,893,170039
2017,浙江,综合,458,822,170861
2017,浙江,综合,457,821,171682
2017,浙江,综合,456,816,172498
2017,浙江,综合,455,832,173330
2017,浙江,综合,454,774,174104
2017,浙江,综合,453,805,174909
2017,浙江,综合,452,813,175722
2017,浙江,综合,451,826,176548
2017,浙江,综合,450,805,177353
2017,浙江,综合,449,814,178167
2017,浙江,综合,448,844,179011
2017,浙江,综合,447,788,179799
2017,浙江,综合,446,816,180615
2017,浙江,综合,445,815,181430
2017,浙江,综合,444,803,182233
2017,浙江,综合,443,771,183004
2017,浙江,综合,442,698,183702
2017,浙江,综合,441,755,184457
2017,浙江,综合,440,749,185206
2017,浙江,综合,439,770,185976
2017,浙江,综合,438,717,186693
2017,浙江,综合,437,700,187393
2017,浙江,综合,436,683,188076
2017,浙江,综合,435,728,188804
2017,浙江,综合,434,689,189493
2017,浙江,综合,433,750,190243
2017,浙江,综合,432,674,190917
2017,浙江,综合,431,651,191568
2017,浙江,综合,430,695,192263
2017,浙江,综合,429,638,192901
2017,浙江,综合,428,672,193573
2017,浙江,综合,427,699,194272
2017,浙江,综合,426,707,194979
2017,浙江,综合,425,657,195636
2017,浙江,综合,424,612,196248
2017,浙江,综合,423,610,196858
2017,浙江,综合,422,691,197549
2017,浙江,综合,421,655,198204
2017,浙江,综合,420,607,198811
2017,浙江,综合,419,645,199456
2017,浙江,综合,418,580,200036
2017,浙江,综合,417,603,200639
2017,浙江,综合,416,605,201244
2017,浙江,综合,415,541,201785
2017,浙江,综合,414,578,202363
2017,浙江,综合,413,594,202957
2017,浙江,综合,412,569,203526
2017,浙江,综合,411,590,204116
2017,浙江,综合,410,531,204647
2017,浙江,综合,409,571,205218
2017,浙江,综合,408,557,205775
2017,浙江,综合,407,538,206313
2017,浙江,综合,406,535,206848
2017,浙江,综合,405,485,207333
2017,浙江,综合,404,542,207875
2017,浙江,综合,403,549,208424
2017,浙江,综合,402,481,208905
2017,浙江,综合,401,486,209391
2017,浙江,综合,400,503,209894
2017,浙江,综合,399,436,210330
2017,浙江,综合,398,460,210790
2017,浙江,综合,397,487,211277
2017,浙江,综合,396,482,211759
2017,浙江,综合,395,445,212204
2017,浙江,综合,394,473,212677
2017,浙江,综合,393,474,213151
2017,浙江,综合,392,451,213602
2017,浙江,综合,391,446,214048
2017,浙江,综合,390,424,214472
2017,浙江,综合,389,442,214914
2017,浙江,综合,388,448,215362
2017,浙江,综合,387,397,215759
2017,浙江,综合,386,386,216145
2017,浙江,综合,385,418,216563
2017,浙江,综合,384,376,216939
2017,浙江,综合,383,368,217307
2017,浙江,综合,382,394,217701
2017,浙江,综合,381,372,218073
2017,浙江,综合,380,339,218412
2017,浙江,综合,379,333,218745
2017,浙江,综合,378,348,219093
2017,浙江,综合,377,338,219431
2017,浙江,综合,376,339,219770
2017,浙江,综合,375,342,220112
2017,浙江,综合,374,329,220441
2017,浙江,综合,373,330,220771
2017,浙江,综合,372,331,221102
2017,浙江,综合,371,326,221428
2017,浙江,综合,370,299,221727
2017,浙江,综合,369,298,222025
2017,浙江,综合,368,286,222311
2017,浙江,综合,367,278,222589
2017,浙江,综合,366,321,222910
2017,浙江,综合,365,291,223201
2017,浙江,综合,364,277,223478
2017,浙江,综合,363,293,223771
2017,浙江,综合,362,273,224044
2017,浙江,综合,361,245,224289
2017,浙江,综合,360,257,224546
2017,浙江,综合,359,285,224831
